R 1920 800
NO ./texture/stone.png
SO ./texture/metal.png
WE ./texture/brick.png
EA ./texture/wood.png
S ./texture/sprite.png
F 220,100,0
C 225,30,0

        1111111111111111111111111
        1000000000002000000000001
        1000222200000000002000001
        100000000000000000N000001
111111111000020000000000000000001
100000000000000000000111100011111
10000000000000001100000010001
10000000000000001100000010001
10000000000000001100000010001
10000000000000001100000010001
10000000000000001100000010001
1000000111000001110000001000111
10000001 1000001 100000010001
11111111 1111111 111111111111