NO ./texture/stone.png
SO ./texture/metal.png
WE ./texture/brick.png
EA ./texture/wood.png
D ./texture/door.png
F 0,255,0
C 0,0,255

        1111111111111111111111111
        1000000000000000000000001
        1000000000000000000000001
        1000000000000000000000001
111111111000000000000000000000001
100000000000000000000121100011111
10000000000000001100000010001
10000000000000001100000010001
1000000000000000110N000010001
10000000000000001100000010001
10000000000000001100000010001
100000011100000111000000100011
10000001 1000001 100000010001
11111111 1111111 111111111111